41 41 41 41 41 41 41 41 
41 41 41 41 41 41 41 41 
41 41 41 41 41 41 41 41 
41 41 41 41 41 41 41 41 
41 41 41 41 41 41 41 41 

19 1a 40 00 00 00 00 00

cc 19 40 00 00 00 00 00

18 00 00 00 00 00 00 00

a2 19 40 00 00 00 00 00

fa 18 40 00 00 00 00 00

35 39 62 39 39 37 66 61 00